wwwwwwwwwwwwwwwwwwwwwwwwwwwwww
w...........................ww
w....1......................ww
wwwwww..........0wwww........w
w............................w
w............................w
w.....A........wwwwww........w
w............................w
w......wwwwwwwww.........wwwww
w......0..............1..wwwww
w...........................ww
w...........................ww
w...........................ww
w...........................ww
wwwwwwwwwwwwwwwwwwwwwwwwwwwwww