wwwwwwwwwwwwwwwwwwwwwwwwwwwwww
w...........................ww
w...........................ww
wwwwww..........0wwww........w
w............................w
w.....1w.....................w
w.....Aw.......wwwwww........w
w......w.....................w
w......w.................wwwww
w......0..............1..wwwww
w...........................ww
w...........................ww
w...........................ww
w...........................ww
wwwwwwwwwwwwwwwwwwwwwwwwwwwwww