wwwwwwwwwwwwwwwwwwwwwwwwwwwwww
w............................w
w....1...........0...........w
wwwwww...........wwww........w
w................w...........w
w......w.....1...w...........w
w.....Aw.........w...........w
w......w.....................w
w......w.............w0......w
w....................w.......w
w....................w.......w
w....................w.......w
w....................w.......w
w............................w
wwwwwwwwwwwwwwwwwwwwwwwwwwwwww