wwwwwwwwwwwwwwwwwwwwwwwwwwwwww
w...........................ww
w...........................ww
wwwwwww......0wwww...........w
w....1.......................w
w.........1..................w
w.....A........wwwwww........w
w............................w
w......wwwwwwwww.........wwwww
w......0.................wwwww
w...........................ww
w...........................ww
w...........................ww
w...........................ww
wwwwwwwwwwwwwwwwwwwwwwwwwwwwww