wwwwwwwwwwwwwwwwwwwwwwwwwwwwww
w...........................ww
w...........................ww
wwwwww...........wwww........w
w................w...........w
w......w...1.....w...........w
w.....Aw.......www...........w
w...1..w.........0...........w
w......w.................wwwww
w......0.................wwwww
w...........................ww
w...........................ww
w...........................ww
w...........................ww
wwwwwwwwwwwwwwwwwwwwwwwwwwwwww