wwwwwwwwwwwwwwwwwwwwwwwwwwwwww
w............................w
w..0.........................w
wwwwww...........wwww........w
w................w...........w
w......w.....1...w...........w
w.....Aw.......www...........w
w......w.....................w
w......w....1.......wwwwwwwwww
w...........................0w
w............................w
w............................w
w............................w
w............................w
wwwwwwwwwwwwwwwwwwwwwwwwwwwwww