wwwwwwwwwwwwwwwwwwwwwwwww
w.......................w
w.........0.....w.......w
w......wwwwwwwwww.......w
w........w......www.....w
w..........A............w
w.....ww......w....w....w
w.....ww...wwww....w0...w
w.....ww................w
wwww...0..........wwwwwww
w.......................w
wwwwwwwwwwwwwwwwwwwwwwwww