wwwwwwwwwwwwwwwwwwwwwwwwwwwwww
w....ww....0.................w
w....ww......................w
wA...ww............wwwwww....w
w.........www....0...www.....w
w............................w
wwww....0..............0.....w
w...........wwwwwww..........w
w...1.....................1..w
w..........0...........ww....w
w.....wwwwww...........ww....w
wwww.......w......0....wwwwwww
w......1...w.................w
w..........w.................w
wwwwwwwwwwwwwwwwwwwwwwwwwwwwww