wwwwwwwwwwwwwwwwwwwwwwwwwwwwww
w............................w
w...A...........w..1.........w
w...............w.........k..w
wwwwwwwwwwwww1wwwwwwwwwwwwwwww
w............................w
w..m.....w.......w...........w
w...m....w.......w...........w
w.m......w.......w.....g.....w
wwwwwwwwwwwwwwwwwwwwwwwwwwwwww
