wwwwwwwwwwwwwwwwwwwwwww
w.....................w
w...A....k.......m....w
w.............1.......w
w.....................w
w...m.................w
w..............w00wwwww
w....1.m.......w......w
w..............w..g..mw
wwwwwwwwwwwwwwwwwwwwwww
