wwwwwwwwwwwwwwwwwwwwwwwwwwwwww
wwwwwwwg................wwwwww
ww..........................ww
ww.............A............ww
ww...11.................1...ww
ww..........................ww
ww..........................ww
ww..........................ww
wwwwwwwww..........wwwwwwwwwww
w.......w....................w
w.....k00....................w
wwwwwwwww..........wwwwwwwwwww
ww..........................ww
ww..m.......................ww
wwwwwwwwwwwwwwwwwwwwwwwwwwwwww