wwwwwwwwwwwwwwwwwwwwwwwwwwww
w......1..........w........w
w.....1g1.........w........w
w......1..........w........w
w..........................w
w..............1...........w
w.......A......1...........w
w..........................w
w...w0w...........wwwwwwwwww
w...w0w...........w........w
w...wkw...........w........w
w...www...........wwwwwwwwww
w..............m...........w
w..m.......................w
wwwwwwwwwwwwwwwwwwwwwwwwwwww
