wwwwwwwwwwwwwwwwwwwwwwwwwwwwww
w.......w..........wwww.....ww
w.......w..1.......wwww.....ww
wwwwwwwwgm.........00kw..1..ww
ww......w..........wwww.....ww
ww....1.........1...........ww
ww.......A..........1.......ww
ww11111111111111111111111111ww
ww00000000000000000000000000ww
ww00000000000000000000000000ww
ww..........................ww
ww..........................ww
ww............k.............ww
wwwwwwwwwwwwwwwwwwwwwwwwwwwwww