wwwwwwwwwwwwwwwwwwwwwwwwwwwwww
w............g...............w
w............................w
w........1.....A.............w
w......................1.....w
w............0...............w
wwwwwwwwwwwww0wwwwwwwwwwwwwwww
w.......w..........w.........w
w.......w.......m..w.........w
w.......w..........w.........w
w.......w..........w.........w
w.......w..........w.........w
w.......wwwwwkwwwwww.........w
wwwwwwwwwwwwwwwwwwwwwwwwwwwwww
