wwwwwwwwwwwwwwwwwwwwwwwwwwwwww
wwww.....................wwwww
w.nnn....................nnn.w
w............................w
w............................w
w........wwwwwwwwwww.........w
w............................w
w............................w
w............................w
wv...........A..............vw
w.....mmm............mmm.....w
w............wwwww...........w
wwwwwwwwwwwwwwwwwwwwwwwwwwwwww
