wwwwwwwwwwwwwwwwwwwwwwwwwwwwww
wwww..d..................wwwww
w.nnn........................w
w............................w
w............................w
w........wwwwwwwwwww.........w
w............................w
w............................w
w............................w
w............A..............vw
w.......................mmm..w
w............wwwww..........vw
wwwwwwwwwwwwwwwwwwwwwwwwwwwwww