wwwwwwwwwwwwwwwwwwwwwwwwwwwwww
w............z...............w
w............................w
w......fa.a..................w
w......ffff............bb....w
w................a.a.........w
w..............a.fff.........w
w..x.........................w
w..........b..............z..w
w...................a........w
w..A.....a.....b.............w
w.....................x......w
w............................w
www.....c........c...........w
wwwwwwwwwwwwwwwwwwwwwwwwwwwwww
