wwwwwwwwwwwwwwwww
w...............w
w.b.............w
w.......fffff...w
w..b..a.f.x.f...w
w.......f..xf...w
w..A....fffff...w
w.........a.....w
www..........b..w
wwwwwwwwwwwwwwwww
