wwwwwwwwwwwwwwwwwwwwwwwwwwwwww
w..........w.................w
w.........+w.............A...w
w.......wwww.................w
w............................w
w.......2....................w
w.................3..........w
w............................w
w............................w
w.....................wwwwwwww
w....2.......................w
w.......wwww.................w
w.........gw.................w
w..........w.................w
wwwwwwwwwwwwwwwwwwwwwwwwwwwwww