wwwwwwwwwwwwwwwwwwwwwwwwwwwwww
w..........w.................w
w..........wg................w
w..........wwwww.............w
w............................w
w............................w
w.......3....................w
w............................w
w............................w
w.....................wwwwwwww
w...........................+w
w..........w.................w
w..........w...........3.....w
wA.........w.................w
wwwwwwwwwwwwwwwwwwwwwwwwwwwwww