wwwwwwwwwwwwwwwwwwwwwwwwwwwwww
w..........w.................w
w..........w.............A...w
w.......wwww.................w
w............................w
w..........3.................w
w............................w
wwwwwww......................w
w............................w
w.....................wwwwwwww
w....2................g......w
w.......wwww.................w
w.........+w...........1.....w
w..........w.................w
wwwwwwwwwwwwwwwwwwwwwwwwwwwwww