wwwwwwwwwwwwwwwwwwwwwwwwwwwwww
w..........w.................w
w..3.......wg..........3.....w
w............................w
w............................w
w............................w
w...................w........w
w...................w........w
w..3.......w........w........w
w..........w+.......w..A.....w
wwwwwwwwwwwwwwwwwwwwwwwwwwwwww