wwwwwwwwwwwwwwwwwwwwwwwwwwwwww
w..........w.................w
w.........gw.............A...w
w.......wwww.................w
w............................w
w..........3.................w
w.....................wwwwwwww
wwwwwww.....................+w
w..................3.........w
w...2........................w
w............................w
w.......wwww.................w
w.......2..w...........1.....w
w..........w.................w
wwwwwwwwwwwwwwwwwwwwwwwwwwwwww